###############################################
###############################################
#..............................................#
#..#########....#####..........................#
#..#.......#....#...+..........................#
#..#.......#....#####..........................#
#..#########...................................#
#......#.......................................#
#......#.......................................#
#......#######.................................#
#......#.....#.................................#
#......#.....#.................................#
#..#####.....#.................................#
#..#...#.....#.................................#
#..#...#.....#.................................#
#..#####.....#.................................#
#............#.................................#
#..#########...................................#
#..#.......#...................................#
#..#.......#...................................#
#..#########...................................#
#.........................###################..#
#.......................#......................#
#.......................#......................#
###############################################
###############################################
###############################################
###############################################
